50 50
################################################# 
################################################# 
################################################# 
###L......###########################...k...##### 
###...@...###########################...S...##### 
###...................p....S..#######...N...##### 
###...........................#######.....p.##### 
###...N...##########.....############...######### 
###...p...##########.....############...######### 
####################.....####    ####...######### 
####################.....############...######### 
####.....................############...######### 
####...P......s.......s..............s.....###### 
####.......s.....s......s.......s.....N..c.###### 
#########.................s................###### 
#########.....################.....############## 
#####....s....################.....############## 
#####.........######S...S#####.......s.....###### 
#######..###########..F..#######...........###### 
#######..############...########...######..###### 
#######..####  #######D#########...######..###### 
#######..####  ####........######D#######s.###### 
#######..####  ####........#####...######.s###### 
#######..####  ####....N...#####...######..###### 
#######..##########.P....P.........####......#### 
#######..##########................####...s..#### 
####........###########################..s...#### 
####..s.....###########################..N...#### 
####................s....#####   ######...s..#### 
####..N.s................#####   ######.P....#### 
####........##########..s#####   ######.....k#### 
####..s.....##########...######################## 
####....s...##########...######################## 
####k......p####  #####D############........p#### 
######################...###########..s..S...#### 
######################...###########.....s...#### 
##......S..........s..............s....s.....#### 
##...s......s..........Ns.....s...........s..#### 
##.............s......s.............s.#...#..#### 
##......s..#############################D######## 
##.........############################...####### 
##p........###    ###....Q....###   ###.T.####### 
#####......##########..S...S..#########...####### 
#####......##########.........##########D######## 
#####............s.........s.............s...#### 
#####.....s........s..N.....N.s...s.......P..#### 
#####..........s...s............s.....s......#### 
################################################# 
################################################# 
################################################# 

