70 38

   ######                       #########       ###############
####....#####                  ##.......#########.............##
#...........#                 ##...............................##
#.....@.....#                 #.................................##
#...........#######     ######.....................##...........####
 #................#######...................##....##...............##
 ##.........................................#######................##
  ###.............................#############...................##
    ##............................#...........###..............####
     #............................##............###............#
    ##.........#############.......###............#...........##
    #......................##.......##............#..........##
    ###.....................#....................##...........####
      #.....................#...................##...............#
      #.........##..........#.................###................#
     ##........##...........##.............####................###
     #..........##...........###........####..................##
     #.........................##########....................##
     #............................##..........................#
     ##...####.....................#####....................###
      #####  #####.................#   #................#####
                 #####.............#####................#
                     #.................##.........########
                   ###..................#....######......#########
      #######   ####..................########...................#
      #.....#####.............#########.........................##
      ##...................####...............................###
       #......................##...............###............#
      ##.......................##...........#### ####.........#
    ###..............##.........#####..........###.........####
    #.................###########........................###
    ######..........................................######
         ######...........................###########
              ######.................######
                    ###################


