50 50
#################################################
#################################################
#################################################
###.......###########################.......#####
###...@...###########################.......#####
###...........................#######.......#####
###...........................#######.......#####
###.......##########.....############...#########
###.......##########.....############...#########
####################.....############...#########
####################.....############...#########
####.....................############...#########
####.......................................######
####.......................................######
#########..................................######
#########.....################.....##############
#####.........################.....##############
#####.........######.....#####.............######
#######..###########.....#######...........######
#######..############...########...######..######
#######..##########.....########...######..######
#######..##########........#####...######..######
#######..##########........#####...######..######
#######..##########........#####...######..######
#######..##########................####......####
#######..##########................####......####
####........###########################......####
####........###########################......####
####.....................##############......####
####.....................##############......####
####........##########...##############......####
####........##########...########################
####........##########...########################
####........##########...###########.........####
######################...###########.........####
######################...###########.........####
##...........................................####
##...........................................####
##...........................................####
##.........############################...#######
##.........############################...#######
##.........#########..........#########...#######
#####......#########..........#########...#######
#####......#########..........#########...#######
#####........................................####
#####........................................####
#####........................................####
#################################################
#################################################
#################################################

